11111111111111
10000000010001
1000C000010001
10000000000C01
10000000010001
10P00000010001
11101111111011
111C1111111E11
11111111111111